111111111111111111111111111111111
1P0C0C0C0C0C0C0C0C0C0C0C0C0C0C0E1
111111111111111111111111111111111