11111111111111111
1C0001000C10000C1
11110101111011111
10E10P001C0000001
10111110111111101
10000000000000001
10000000000000001
10000000000000001
10000000000000001
10000000000000001
10000000000000001
10000000000000001
10000000000000001
10000000000000001
11111111111111111












