11111111111111111111111111111111
1E0001P0000000000000000000001111
11110111111111110000000000001111
1C000000000000000000000000001111
11111101110101111000000000001111
1C000001C0010000C000000000001111
11111111111111111111111111101111
11111111111111111111111111101111
11111111111111111111111000001111
11111111111111111111111111101111
11111111111111111111111111111111
11111111111111111111111111111111
11111111111111111111111111111111
11111111111111111111111111111111
11111111111111111111111111111111
10000000000000000000000000000001
10000000000000000000000000000001
11111111111111111111111111111111