111111111111111111111
1PCCCCCCCCCCCCCCCCCC1
1CCCCCCCCCCCCCCCCCCC1
1CCCCCCCCCCCCCCCCCCC1
1CCCCCCCCCCCCCCCCCCC1
1CCCCCCCCCCCCCCCCCCC1
1CCCCCCCCCCCCCCCCCCC1
1CCCCCCCCCCCCCCCCCCC1
1CCCCCCCCECCCCCCCCCC1
1CCCCCCCCCCCCCCCCCCC1
1CCCCCCCCCCCCCCCCCCC1
1CCCCCCCCCCCCCCCCCCC1
1CCCCCCCCCCCCCCCCCCC1
1CCCCCCCCCCCCCCCCCCC1
1CCCCCCCCCCCCCCCCCCC1
1CCCCCCCCCCCCCCCCCCC1
111111111111111111111