1111111111
1C100000C1
1111011111
1E000000P1
1111110001
1000000001
1010111111
1C100000C1
1111111111