1111111111111111111111111111
1C000000000000000000000000C1
100000000000C000000000C00001
1000000000011100111111100001
1000000000111000111111100001
100000000111000A1100C1100001
10000000111000001000111C0001
100000C111000000000111000001
10000011100000P0001110000001
10000111C0000000011100100001
10001111111111C0111C01100001
1000111111111100111111100001
1000C000000E1100111111100001
1000000000001100000000C00001
1000000000001100000000000001
1000000000001100000000000001
1000000000000C00000000000001
1C00000000000000000000000001
1111111111111111111111111111