11111111111
1P0000000C1
11110110001
1C000C10001
10001E10001
10101C00101
10100000111
10000A000C1
11111111111