1111111111111111111
1000010000000000001
1C00E00P00C00000001
1C00000000C00000001
1C00000000C00000001
1C00000000C00C01101
1C00000000000C01001
1C00000000C00C01001
1C00000000C00C01001
1C00000000C00C010C1
1111111111111111111