1111111111
1C00000001
1111111001
1E000000P1
1111110001
1C10000001
1010111111
10000000C1
1111111111